15 30
1 0
##############################
#$           $       $       #
#   #     #                  #
#   #     #                  #
#   #  $  #   ########       #
#   #     #   #      #       #
#   #     #    #      #      #
#      *         #     #     #
#   #     #       #     #    #
#   #     #   #   $$    #    #
#   #  $  #   #              #
#   #     #                  #
#   #     #         ######   #
#$           $#              #
##############################